1111111111111
11100000000011
1111111111001
1000000000011
1PE0000000011
1111111111111