111111111111111111111111111111111111111111111111111111111111111111111111111111111111111111111111111111111111111111111111111111111111111111111111111111111111111111111111111111111111111111111111111111111111111111111111111111111111111111
100100000C00100100000C00100100000C00100100000C00100100000C00100100000C00100100000C00100100000C00100100000C00100100000C00100100000C00100100000C00100100000C00100100000C00100100000C00100100000C00100100000C00100100000C00100100000C00100101
100100000C00100100000C00100100000C00100100000C00100100000C00100100000C00100100000C00100100000C00100100000C00100100000C00100100000C00100100000C00100100000C00100100000C00100100000C00100100000C00100100000C00100100000C00100100000C00100101
100100000C00100100000C00100100000C00100100000C00100100000C00100100000C00100100000C00100100000C00100100000C00100100000C00100100000C00100100000C00100100000C00100100000C00100100000C00100100000C00100100000C00100100000C00100100000C00100101
100100000C00100100000C00100100000C00100100000C00100100000C00100100000C00100100000C00100100000C00100100000C00100100000C00100100000C00100100000C00100100000C00100100000C00100100000C00100100000C00100100000C00100100000C00100100000C00100101
100100000C00100100000C00100100000C00100100000C00100100000C00100100000C00100100000C00100100000C00100100000C00100100000C00100100000C00100100000C00100100000C00100100000C00100100000C00100100000C00100100000C00100100000C00100100000C00100101
100100000C00100100000C00100100000C00100100000C00100100000C00100100000C00100100000C0010E100000C00100100000C00100100000C00100100000C00100100000C00100100000C00100100000C00100100000C00100100000C00100100000C00100100000C00100100000C00100101
100100000C00100100000C00100100000C00100100000C00100100000C00100100000C001001P0000C00100100000C00100100000C00100100000C00100100000C00100100000C00100100000C00100100000C00100100000C00100100000C00100100000C00100100000C00100100000C00100101
100100000C00100100000C00100100000C00100100000C00100100000C00100100000C00100100000C00100100000C00100100000C00100100000C00100100000C00100100000C00100100000C00100100000C00100100000C00100100000C00100100000C00100100000C00100100000C00100101
100100000C00100100000C00100100000C00100100000C00100100000C00100100000C00100100000C00100100000C00100100000C00100100000C00100100000C00100100000C00100100000C00100100000C00100100000C00100100000C00100100000C00100100000C00100100000C00100101
100100000C00100100000C00100100000C00100100000C00100100000C00100100000C00100100000C00100100000C00100100000C00100100000C00100100000C00100100000C00100100000C00100100000C00100100000C00100100000C00100100000C00100100000C00100100000C00100101
100100000C00100100000C00100100000C00100100000C00100100000C00100100000C00100100000C00100100000C00100100000C00100100000C00100100000C00100100000C00100100000C00100100000C00100100000C00100100000C00100100000C00100100000C00100100000C00100101
100100000C00100100000C00100100000C00100100000C00100100000C00100100000C00100100000C00100100000C00100100000C00100100000C00100100000C00100100000C00100100000C00100100000C00100100000C00100100000C00100100000C00100100000C00100100000C00100101
100100000C00100100000C00100100000C00100100000C00100100000C00100100000C00100100000C00100100000C00100100000C00100100000C00100100000C00100100000C00100100000C00100100000C00100100000C00100100000C00100100000C00100100000C00100100000C00100101
111111111111111111111111111111111111111111111111111111111111111111111111111111111111111111111111111111111111111111111111111111111111111111111111111111111111111111111111111111111111111111111111111111111111111111111111111111111111111111
