1111111111111111111111
1000001P0000000000C111
1011101011C11010111011
101111101110101000E011
1111111111111111111111
