11111111111111111111111111111
100E000000000C000000000000001
10100101001000001010010010101
10100100101010100010010010101
1P000000000000000000000000001
11111111111111111111111111111
