11111111
100000C1
1CPC1111
100E0011
10001101
11111111
